unfounded	/ʌnˈfaʊndɪd/	If a claim or piece of news is unfounded, it is not based on fact 	Our fears about the weather proved totally unfounded.
interminable	/ɪnˈtɜːmɪnəbəl/	continuing for too long and therefore boring or annoying 	an interminable delay
cessation	/sesˈeɪʃən/	ending or stopping 	Religious leaders have called for a total cessation of the bombing campaign.
fervency	/ˈfɜːvər/	strong and sincere beliefs 	The country was swept by patriotic fervour.
heedless	/ˈhiːdləs/	not giving attention to a risk or possible difficulty 	Heedless destruction of the rainforests is contributing to global warming.
sedate	/sɪˈdeɪt/	avoiding excitement or great activity and usually calm and relaxed 	The fight against a chemical storage site has transformed a normally sedate village into a battleground.
lumbering	/ˈlʌmbər/	present participle of lumber 	In the distance, we could see a herd of elephants lumbering across the plain.
dexterous	/dekˈsterəti/	the ability to perform a difficult action quickly and skilfully with the hands 	He caught the ball with great dexterity.
adroit	/əˈdrɔɪt/	very skilful and quick in the way you think or move 	an adroit reaction/answer/movement of the hand
implicit	/ɪmˈplɪsɪt/	suggested but not communicated directly 	He interpreted her comments as an implicit criticism of the government.
abiding	/əˈbaɪdɪŋ/	An abiding feeling or memory is one that you have had for a long time 	My abiding memory is of him in the garden.
protracted	/prəˈtræktɪd/	lasting for a long time or made to last longer than necessary 	protracted negotiations
garner	/ˈɡɑːnər/	to collect something, usually after much work or with difficulty 	Coppola garnered several Oscar awards for "The Godfather".
placate	/pləˈkeɪt/	to stop someone from feeling angry 	Outraged minority groups will not be placated by promises of future improvements.
scant	/skænt/	very little and not enough 	He pays scant attention to the needs of his children.
copious	/ˈkəʊpiəs/	in large amounts, or more than enough 	They drank copious amounts of wine.
solvent	/ˈsɒlvənt/	(especially of companies) having enough money to pay all the money that is owed to other people 	Many insurance companies are under pressure to increase premiums to stay solvent.
measured	/ˈmeʒəd/	careful and controlled, or not fast 	Her response to their criticism was calm and measured.
profuse	/prəˈfjuːs/	produced or given in large amounts 	She was admitted to St Mary's Hospital with profuse bleeding.
aloof	/əˈluːf/	not friendly or willing to take part in things 	She seemed rather aloof when in fact she was just shy.
propitiatory	/prəˌpɪʃiˈeɪtəri/	intended to please someone and make them feel calm 	a propitiatory gesture
elucidate	/iˈluːsɪdeɪt/	to explain something or make something clear 	I don't understand. You'll have to elucidate.
replete	/rɪˈpliːt/	full, especially with food 	After two helpings of dessert, Sergio was at last replete.
proponent	/prəˈpəʊnənt/	a person who speaks publicly in support of a particular idea or plan of action 	He is one of the leading proponents of capital punishment.
discomfiting	/dɪˈskʌmfɪt/	present participle of discomfit 	She turned away to hide her discomfiture.
mortifying	/ˈmɔːtɪfaɪɪŋ/	very embarrassing 	Catching head lice from your kids is a mortifying experience.
monumental	/ˌmɒnjəˈmentəl/	very big 	a monumental task
divisive	/dɪˈvaɪsɪv/	used to describe something that causes great and sometimes unfriendly disagreement within a group of people 	The Vietnam war was an extremely divisive issue in the US
hegemonic	/ˌheɡɪˈmɒnɪk/	strong and powerful and therefore able to control others, or relating to the idea that a country is like this 	Now a different hegemonic power sought to force its will on the rest of the world.
fervent	/ˈfɜːvənt/	used to describe beliefs that are strongly and sincerely felt or people who have strong and sincere beliefs 	a fervent supporter of the communist party
flagging	/ˈflæɡɪŋ/	becoming weaker 	flagging energy/enthusiasm
iturn			
voluble	/ˈvɒljəbəl/	speaking a lot, with confidence and enthusiasm 	She was a voluble, smart, funny interviewee.
garrulous	/ˈɡærələs/	having the habit of talking a lot, especially about things that are not important	I had talked too much about myself and felt like a garrulous old fool.
paucity	/ˈpɔːsəti/	the fact that there is too little of something 	There is a paucity of information on the ingredients of many cosmetics.
impertinent	/ɪmˈpɜːtɪnənt/	rude and not showing respect, especially towards someone older or in a higher position than you 	I hope he didn't think I was being impertinent when I asked him about his private life.
plaintive	/ˈpleɪntɪv/	used to describe something that sounds slightly sad 	the plaintive sound of the bagpipes
oblique	/əˈbliːk/	having a sloping direction, angle, or position 	Through the window came the last few oblique rays of evening sunshine.
abysmal	/əˈbɪzməl/	very bad 	abysmal working conditions
dulcet	/ˈdʌlsət/	Dulcet sounds are soft and pleasant to listen to.	
artless	/ˈɑːtləs/	simple and not wanting to deceive 	"Why did you take the money?" she asked the child. "Because I wanted it," came the artless reply.
comely	/ˈkʌmli/	A comely woman is attractive in appearance.	
facile	/ˈfæsaɪl/	A facile remark or theory is too simple and has not been thought about enough 	a facile explanation
inscrutable	/ɪnˈskruːtəbəl/	not showing emotions or thoughts and therefore very difficult to understand or get to know 	an inscrutable face/expression/smile
transfixed	/trænsˈfɪkst/	(of a person or animal) unable to move, usually because of great fear or interest in something 	The entire nation will sit transfixed in front of TV sets.
superannuated	/ˌsuːpərˈænjueɪtɪd/	old, and almost no longer suitable for work or use	
avant-garde	/ˌævɑ̃ːˈɡɑːd/	the painters, writers, musicians, and other artists whose ideas, styles, and methods are very original or modern in comparison to the period in which they live, or the work of these artists 	New York is the international capital of the musical avant-garde.
gainsaid		past simple and past participle of gainsay  formal	
abstruse	/æbˈstruːs/	not known or understood by many people 	an abstruse philosophical essay
manifest	/ˈmænɪfest/	to show something clearly, through signs or actions 	The workers chose to manifest their dissatisfaction in a series of strikes.
cryptic	/ˈkrɪptɪk/	mysterious and difficult to understand 	I got a cryptic text message from Sam.
recalcitrant	/rɪˈkælsɪtrənt/	(of a person) unwilling to obey orders or to do what should be done, or (of an animal) refusing to be controlled	Tenants petitioned their recalcitrant landlord to finish repairs to their building.
quaint	/kweɪnt/	attractive because of being unusual and especially old-fashioned 	a quaint old cottage
decidedly	/dɪˈsaɪdɪdli/	certainly and obviously 	He was decidedly careful about what he told me.
imposing	/ɪmˈpəʊzɪŋ/	having an appearance that looks important or causes admiration 	an imposing mansion
germane	/dʒɜːˈmeɪn/	Ideas or information that is germane to a particular subject or situation is connected with and important to it 	Her remarks could not have been more germane to the discussion.
gentrified	/ˈdʒentrɪfaɪ/	past simple and past participle of gentrify 	The area where I grew up has been all modernized and gentrified, and has lost all its old character.
aplomb	/əˈplɒm/	confidence and style 	Rosalind conducted the meeting with characteristic aplomb/with her usual aplomb.
rancorous	/ˈræŋkərəs/	having or showing a feeling of hate and continuing anger about something in the past 	a rancorous dispute
thrall	/θrɔːl/	If you are in thrall to someone or something, or in the thrall of someone or something, he, she, or it has a lot of power to control you 	Her love for him was like a madness, and she was completely in its thrall.
amateurish	/ˈæmətərɪʃ/	having no skill, or showing no skill 	Their website looks amateurish.
tonic	/ˈtɒnɪk/	a liquid medicine that has the general effect of making you feel better rather than treating a particular health problem that you might have	The magazine is lively and interesting - the pictures alone are a tonic.
slick	/slɪk/	operating or performing skilfully and effectively, without problems and without seeming to need effort 	Manilow gave the slick, polished performance that we've come to expect.
homogeneity	/ˌhɒməˈdʒiːniəs/	consisting of parts or people that are similar to each other or are of the same type 	a homogeneous group/society
amalgamation	/əˌmælɡəˈmeɪʃən/	the process in which separate organizations unite to form a larger organization or group, or an organization or group formed in this way 	The association was formed by the amalgamation of several regional environmental organizations.
synergy	/ˈsɪnədʒi/	the combined power of a group of things when they are working together that is greater than the total power achieved by each working separately 	Team work at its best results in a synergy that can be very productive.
conglomeration	/kənˌɡlɒmərˈeɪʃən/	a large group or mass of different things all collected together in an untidy or unusual way 	There was a strange conglomeration of objects on the mantelpiece.
syllogism	/ˈsɪlədʒɪzəm/	(in philosophy) a process of logic in which two general statements lead to a more particular statement	
idiosyncrasy	/ˌɪdiəˈsɪŋkrəsi/	a strange or unusual habit, way of behaving, or feature that someone or something has 	She often cracks her knuckles when she's speaking - it's one of her little idiosyncrasies.
prodigal	/ˈprɒdɪɡəl/	spending large amounts of money without thinking of the future, in a way that is not wise 	There have been rumours that he has been prodigal with company funds.
profligate	/ˈprɒflɪɡət/	spending money or using something in a way that wastes it and is not wise 	She is well-known for her profligate spending habits.
pugnacious	/pʌɡˈneɪʃəs/	wanting to start an argument or fight, or expressing an argument or opinion very forcefully 	I found him pugnacious and arrogant.
lavish	/ˈlævɪʃ/	large in quantity and expensive or impressive 	lavish gifts/promises/praise
compendium	/kəmˈpendiəm/	a short but complete account of a particular subject, especially in the form of a book 	the Gardener's Compendium
encomium	/ɪnˈkəʊmiəm/	a piece of writing, speech, etc. that praises someone or something	
jeremiad	/ˌdʒerɪˈmaɪæd/	a long list of complaints or problems 	The critic delivers regular jeremiads against the contemporary art world.
philippic			
panegyric	/ˌpænəˈdʒɪrɪk/	a speech or piece of writing that praises someone very much and does not mention anything bad about them 	She delivered a panegyric on the president-elect.
