quotidian	/kwəʊˈtɪdiən/	ordinary 	Television has become part of our quotidian existence.
divulge	/daɪˈvʌldʒ/	to make something secret known 	Journalists do not divulge their sources.
disparage	/dɪˈspærɪdʒ/	to criticize someone or something in a way that shows you do not respect or value him, her, or it 	The actor's work for charity has recently been disparaged in the press as an attempt to get publicity.
renege	/rɪˈneɪɡ/	to fail to keep a promise or an agreement, etc. 	If you renege on the deal now, I'll fight you in the courts.
aggrandize	/əˈɡrændaɪz/	to make someone more powerful or important	
acerbic	/əˈsɜːbɪk/	used to describe something that is spoken or written in a way that is direct, clever, and cruel 	The letters show the acerbic wit for which Parker was both admired and feared.
neophyte	/ˈniːəfaɪt/	someone who has recently become involved in an activity and is still learning about it	This computer course is for neophytes.
quixotic	/kwɪkˈsɒtɪk/	having or showing ideas that are different and unusual but not practical or likely to succeed 	This is a vast, exciting and some say quixotic project.
anachronism	/əˈnækrənɪzəm/	a person, thing, or idea that exists out of its time in history, especially one that happened or existed later than the period being shown, discussed, etc. 	For some people, marriage is an anachronism from the days when women needed to be protected.
vacillate	/ˈvæsɪleɪt/	to be uncertain what to do, or to change often between two opinions 	Her mood vacillated between hope and despair.
ostentatious	/ˌɒstenˈteɪʃəs/	too obviously showing your money, possessions, or power, in an attempt to make other people notice and admire you 	They criticized the ostentatious lifestyle of their leaders.
intrepid	/ɪnˈtrepɪd/	extremely brave and showing no fear of dangerous situations 	a team of intrepid explorers
obfuscate	/ˈɒbfʌskeɪt/	to make something less clear and harder to understand, especially intentionally 	She was criticized for using arguments that obfuscated the main issue.
laconic	/ləˈkɒnɪk/	using very few words to express what you mean 	She had a laconic wit.
unfeigned			
pungent	/ˈpʌndʒənt/	A pungent smell or taste is very strong, sometimes unpleasantly strong 	the pungent whiff of a goat
vituperate			
obstinate	/ˈɒbstɪnət/	unreasonably determined, especially to act in a particular way and not to change at all, despite what anyone else says 	He can be very obstinate at times.
imminent	/ˈɪmɪnənt/	coming or likely to happen very soon 	imminent disaster/danger
spendthrift	/ˈspendθrɪft/	someone who spends a lot of money in a way that wastes it 	Max was a spendthrift and a heavy gambler. 
phlegmatic	/fleɡˈmætɪk/	A phlegmatic person does not usually get emotional or excited about things 	As a football player, his great asset was his calm, phlegmatic manner.
astringent	/əˈstrɪndʒənt/	a drug or cream that causes the skin or other tissue to tighten 	You can use an astringent to make your skin less oily.
desiccate			
proclivity	/prəˈklɪvəti/	the fact that someone likes something or likes to do something, especially something considered morally wrong 	the sexual proclivities of celebrities
decorum	/dɪˈkɔːrəm/	behaviour that is controlled, calm, and polite 	As young ladies we were expected to act/behave with proper decorum.
rarefy	/ˈreərɪfaɪ/	to become less solid or dense; to make something do this 	The primordial cosmic soup is full of sound waves compressing and rarefying matter and light.
pervade	/pəˈveɪd/	When qualities, characteristics, or smells pervade a place or thing, they spread through it and are present in every part of it 	The film movie is a reflection of the violence that pervades our culture.
vigilant	/ˈvɪdʒələnt/	always being careful to notice things, especially possible danger 	Following the bomb scare at the airport, the staff have been warned to be extra vigilant.
inimical	/ɪˈnɪmɪkəl/	harmful or limiting 	Excessive managerial control is inimical to creative expression.
terse	/tɜːs/	using few words, sometimes in a way that seems rude or unfriendly 	"Are you feeling any better?" "No!" was the terse reply.
sedulous	/ˈsedʒələs/	careful and using a lot of effort 	It was agreed that the few students sedulous enough to read the book deserved top marks for diligence.
shard	/ʃɑːd/	a piece of a broken glass, cup, container, or similar object 	Shards of glass have been cemented into the top of the wall to stop people climbing over.
impetuous	/ɪmˈpetʃuəs/	likely to do something suddenly, without considering the results of your actions 	He's so impetuous - why can't he think things over before he rushes into them?
profligate	/ˈprɒflɪɡət/	spending money or using something in a way that wastes it and is not wise 	She is well-known for her profligate spending habits.
fawn	/fɔːn/	a young deer	Big movie stars are fawned over by the waiters at the restaurant.
credulous	/ˈkredʒələs/	too willing to believe what you are told and so easily deceived	
variegated	/ˈveərɪɡeɪtɪd/	having a pattern of different colours or marks 	variegated leaves
volatile	/ˈvɒlətaɪl/	likely to change suddenly and unexpectedly, especially by getting worse 	Food and fuel prices are very volatile in a war situation.
untenable	/ʌnˈtenəbəl/	If a theory or argument is untenable, it cannot be supported or defended against criticism.	If three people in four no longer support the government, isn't this an untenable situation?
plethora	/ˈpleθərə/	a very large amount of something, especially a larger amount than you need, want, or can deal with 	There's a plethora of books about the royal family.
soporific	/ˌsɒpərˈɪfɪk/	causing sleep or making a person want to sleep 	the soporific effect of the heat
refulgent	/rɪˈfʌldʒənt/	shining with a bright light 	the beauty of her refulgent face
derision	/dɪˈrɪʒən/	the situation in which someone or something is laughed at and considered stupid or of no value 	They treated his suggestion with derision.
hubris	/ˈhjuːbrɪs/	a way of talking or behaving that is too proud 	He was punished for his hubris.
dilettante	/ˌdɪləˈtænti/	a person who is or seems to be interested in a subject, but whose understanding of it is not very deep or serious 	He's a bit of a dilettante as far as wine is concerned.
propensity	/prəˈpensəti/	the fact that someone is likely to behave in a particular way, especially a bad way 	She's inherited from her father a propensity to talk too much.
trenchant	/ˈtrentʃənt/	severe, expressing strong criticism or forceful opinions 	His most trenchant criticism is reserved for the party leader, whom he describes as "the most incompetent and ineffectual the party has known".
contiguous	/kənˈtɪɡjuəs/	next to or touching another, usually similar, thing 	The two states are contiguous with/to each other, but the laws are quite different.
mercurial	/mɜːˈkjʊəriəl/	changing suddenly and often 	a mercurial temperament
amenable	/əˈmiːnəbəl/	willing to accept or be influenced by a suggestion 	She might be more amenable to the idea if you explained how much money it would save.
alchemy	/ˈælkəmi/	a type of chemistry, especially in the Middle Ages, that dealt with trying to find a way to change ordinary metals into gold and with trying to find a medicine that would cure any disease	She manages, by some extraordinary alchemy, to turn the most ordinary of ingredients into the most delicious of dishes.
vexation	/vekˈseɪʃən/	worry or anger 	After several unsuccessful attempts to start his car, he swore in vexation.
flout	/flaʊt/	to intentionally not obey a rule, law, or custom 	Many motorcyclists flout the law by not wearing helmets.
cynicism	/ˈsɪnɪkəl/	believing that people are only interested in themselves and are not sincere 	She has a pretty cynical view of men.
garrulous	/ˈɡærələs/	having the habit of talking a lot, especially about things that are not important	I had talked too much about myself and felt like a garrulous old fool.
recondite	/ˈrekəndaɪt/	not known about by many people and difficult to understand 	We had to work from material that was both complex and recondite.
tacit	/ˈtæsɪt/	understood without being expressed directly 	tacit agreement/approval/support
prosaic	/prəˈzeɪɪk/	without interest, imagination, and excitement 	If only she'd been called Camilla or Flavia instead of the prosaic Jane.
