bolster	/ˈbəʊlstər/	to support or improve something or make it stronger 	More money is needed to bolster the industry.
rescind	/rɪˈsɪnd/	to make a law, agreement, order, or decision no longer have any (legal) power 	The policy of charging air travellers for vegetarian meals proved unpopular and has already been rescinded.
evanescent	/ˌiːvəˈnesənt/	lasting for only a short time, then disappearing quickly and being forgotten	
obsequious	/əbˈsiːkwiəs/	too eager to praise or obey someone 	She is embarrassingly obsequious to anyone in authority.
infelicitous	/ˌɪnfəˈlɪsɪtəs/	not suitable for the occasion 	an infelicitous remark
repudiate	/rɪˈpjuːdieɪt/	to refuse to accept something or someone as true, good, or reasonable 	He repudiated the allegation/charge/claim that he had tried to deceive them.
inchoate	/ɪnˈkəʊeɪt/	only recently or partly formed, or not completely developed or clear 	She had a child's inchoate awareness of language.
implacable	/ɪmˈplækəbəl/	used to describe (someone who has) strong opinions or feelings that are impossible to change 	an implacable enemy
aver	/əˈvɜːr/	to say that something is certainly true 	The lawyer averred her client's innocence.
salubrious	/səˈluːbriəs/	A salubrious place is pleasant, clean, and healthy to live in 	He doesn't live in a very salubrious part of town.
hackneyed	/ˈhæknid/	A hackneyed phrase or idea has been said or used so often that it has become boring and has no meaning 	The plot of the film is just a hackneyed boy-meets-girl scenario.
dissemble	/dɪˈsembəl/	to hide your real intentions and feelings or the facts 	He accused the government of dissembling.
adulterate	/əˈdʌltəreɪt/	to make food or drink weaker or to lower its quality, by adding something else 	There were complaints that the beer had been adulterated with water.
misanthrope	/ˈmɪsənθrəʊp/	someone who dislikes and avoids other people	
querulous	/ˈkwerələs/	often complaining, especially in a weak high voice 	He became increasingly dissatisfied and querulous in his old age.
endemic	/enˈdemɪk/	especially of a disease or a condition, regularly found and very common among a particular group or in a particular area 	Malaria is endemic in many of the hotter regions of the world.
loquacious	/ləˈkweɪʃəs/	Someone who is loquacious talks a lot.	
surfeit	/ˈsɜːfɪt/	an amount that is too large, or is more than is needed 	The country has a surfeit of cheap labour.
grandiloquence	/ɡrænˈdɪləkwəns/	a style or manner of speaking that uses complicated language in order to attract admiration and attention, especially in order to make someone or something seem important 	His grandiloquence was a powerful weapon that he used to overcome rivals and enemies.
malleable	/ˈmæliəbəl/	A malleable substance is easily changed into a new shape 	Lead and tin are malleable metals.
tenacity	/təˈnæsəti/	the determination to continue what you are doing	
idolatrous	/aɪˈdɒlətrəs/	relating to the religious practice of praying to a picture or object 	Authorities destroyed a number of statues that were deemed idolatrous.
pedagogy	/ˈpedəɡɒdʒi/	the study of the methods and activities of teaching	
polemical	/pəˈlemɪkəl/	(of a piece of writing or a speech) strongly attacking or defending a particular opinion, person, idea, or set of beliefs 	a polemical essay
mendacity	/menˈdæsəti/	the act of not telling the truth 	Politicians are often accused of mendacity.
iconoclast	/aɪˈkɒnəklæst/	a person who strongly opposes generally accepted beliefs and traditions 	Rogers, an iconoclast in architecture, is sometimes described as putting the insides of buildings on the outside.
prodigal	/ˈprɒdɪɡəl/	spending large amounts of money without thinking of the future, in a way that is not wise 	There have been rumours that he has been prodigal with company funds.
occlude	/əˈkluːd/	to block something 	Veins can get occluded by blood clots.
platitude	/ˈplætɪtjuːd/	a remark or statement that may be true but is boring and has no meaning because it has been said so many times before 	He doesn't mouth platitudes about it not mattering who scores as long as the team wins.
halcyon	/ˌhælsiən ˈdeɪz/	a very happy or successful period in the past 	She recalled the halcyon days of her youth.
impunity	/ɪmˈpjuːnəti/	freedom from punishment or from the unpleasant results of something that has been done 	Criminal gangs are terrorizing the city with apparent impunity.
imperturbable	/ˌɪmpəˈtɜːbəbəl/	always staying calm and controlled, even in difficult situations that would cause other people to worry	He was imperturbable in a crisis.
fortuitous	/fɔːˈtʃuːɪtəs/	(of something that is to your advantage) not planned, happening by chance 	The timing of the meeting is certainly fortuitous.
succinct	/səkˈsɪŋkt/	said in a clear and short way; expressing what needs to be said without unnecessary words 	Keep your letter succinct and to the point.
tirade	/taɪˈreɪd/	a long, angry speech expressing strong disapproval 	She launched into an angry/furious tirade about how she had been unfairly treated.
impassive	/ɪmˈpæsɪv/	If someone's face is impassive, it expresses no emotion, because the person seems not to be affected by the situation they are experiencing.	The defendant sat impassively in the dock while evidence was given against him.
diatribe	/ˈdaɪətraɪb/	an angry speech or piece of writing that severely criticizes something or someone 	He launched into a long diatribe against the lack of action in Congress.
luminous	/ˈluːmɪnəs/	producing or reflecting bright light, especially in the dark 	luminous clothing
meticulous	/məˈtɪkjələs/	very careful and with great attention to every detail 	Many hours of meticulous preparation have gone into writing the book.
acumen	/ˈækjəmən/	skill in making correct decisions and judgments in a particular subject, such as business or politics 	She has considerable business/financial acumen.
superfluous	/suːˈpɜːfluəs/	more than is needed or wanted 	The report was marred by a mass of superfluous detail.
pirate	/ˈpaɪrət/	a person who sails in a ship and attacks other ships in order to steal from them	software pirates
profuse	/prəˈfjuːs/	produced or given in large amounts 	She was admitted to St Mary's Hospital with profuse bleeding.
germane	/dʒɜːˈmeɪn/	Ideas or information that is germane to a particular subject or situation is connected with and important to it 	Her remarks could not have been more germane to the discussion.
spurious	/ˈspjʊəriəs/	false and not what it appears to be, or (of reasons and judgments) based on something that has not been correctly understood and therefore false 	Some of the arguments in favour of shutting the factory are questionable and others downright spurious.
plummet	/ˈplʌmɪt/	to fall very quickly and suddenly 	House prices have plummeted in recent months.
obdurate	/ˈɒbdʒərət/	extremely determined to act in a particular way and not to change despite what anyone else says 	The president remains obdurate on immigration.
pithy	/ˈpɪθi/	(of speech or writing) expressing an idea cleverly in a few words 	a pithy remark
rancorous	/ˈræŋkərəs/	having or showing a feeling of hate and continuing anger about something in the past 	a rancorous dispute
recalcitrant	/rɪˈkælsɪtrənt/	(of a person) unwilling to obey orders or to do what should be done, or (of an animal) refusing to be controlled	Tenants petitioned their recalcitrant landlord to finish repairs to their building.
insipid	/ɪnˈsɪpɪd/	not having a strong taste or character, or having no interest or energy 	a pale insipid wine
amalgamate	/əˈmælɡəmeɪt/	to join or unite to form a larger organization or group, or to make separate organizations do this 	The electricians' union is planning to amalgamate with the technicians' union.
solvent	/ˈsɒlvənt/	(especially of companies) having enough money to pay all the money that is owed to other people 	Many insurance companies are under pressure to increase premiums to stay solvent.
pine	/paɪn/	an evergreen tree (= one that never loses its leaves) that grows in cooler areas of the world 	a plantation of pines
pith	/pɪθ/	the white substance between the skin and the flesh of citrus fruits such as oranges, or the soft, white inside part of the stem of some plants	
fervent	/ˈfɜːvənt/	used to describe beliefs that are strongly and sincerely felt or people who have strong and sincere beliefs 	a fervent supporter of the communist party
subpoena	/səˈpiːnə/	to order someone to go to a law court to answer questions 	A friend of the victim was subpoenaed as a witness by lawyers representing the accused.
malevolent	/məˈlevələnt/	causing or wanting to cause harm or evil 	The central character is a malevolent witch out for revenge.
placate	/pləˈkeɪt/	to stop someone from feeling angry 	Outraged minority groups will not be placated by promises of future improvements.
