quaff	/kwɒf/	to drink something quickly or in large amounts	
furtive	/ˈfɜːtɪv/	(of people) behaving secretly and often dishonestly, or (of actions) done secretly and often dishonestly 	I saw him cast a furtive glance at the woman at the table to his right.
cacophony	/kəˈkɒfəni/	an unpleasant mixture of loud sounds 	What a cacophony!
caustic	/ˈkɔːstɪk/	A caustic chemical burns or destroys things, especially anything made of living cells 	a caustic substance
adulation	/ˌædʒəˈleɪʃən/	very great admiration or praise for someone, especially when it is more than is deserved 	As a born performer, she loves the excitement and she loves the adulation.
torpid	/ˈtɔːpɪd/	not active; moving or thinking slowly, especially as a result of being lazy or feeling that you want to sleep 	If you have a sudden loss of cabin pressure at 20,000 feet, passengers will become torpid and then lose consciousness.
axiom	/ˈæksiəm/	a statement or principle that is generally accepted to be true, but need not be so 	It is a widely held axiom that governments should not negotiate with terrorists.
innocuous	/ɪˈnɒkjuəs/	completely harmless (= causing no harm) 	Some mushrooms look innocuous but are in fact poisonous.
putrefy	/ˈpjuːtrɪfaɪ/	to decay, producing a strong, unpleasant smell 	the smell of putrefying flesh
supplant	/səˈplɑːnt/	to replace 	Printed books will soon be supplanted by e-books.
squalid	/ˈskwɒlɪd/	(of places) extremely dirty and unpleasant, often because of lack of money 	Many prisons, even today, are overcrowded and squalid places.
eulogy	/ˈjuːlədʒi/	a speech, piece of writing, poem, etc. containing great praise, especially for someone who recently died or retired from work 	He was the most self-effacing of men - the last thing he would have relished was a eulogy.
vilify	/ˈvɪlɪfaɪ/	to say or write unpleasant things about someone or something, in order to cause other people to have a bad opinion of them 	He was vilified by the press as a monster.
stoic	/ˈstəʊɪk/	determined not to complain or show your feelings, especially when something bad happens to you 	We knew she must be in pain, despite her stoic attitude.
impecunious	/ˌɪmpəˈkjuːniəs/	having very little money 	I first knew him as an impecunious student living in a tiny apartment.
demur	/dɪˈmɜːr/	to express disagreement or refuse to do something 	The lawyer requested a break in the court case, but the judge demurred.
gregarious	/ɡrɪˈɡeəriəs/	(of people) liking to be with other people  	Emma's a gregarious, outgoing sort of person.
contrite	/kənˈtraɪt/	feeling very sorry and guilty for something bad that you have done 	a contrite apology/expression
fallacy	/ˈfæləsi/	an idea that a lot of people think is true but is in fact false 	It is a common fallacy that women are worse drivers than men.
dogmatic	/dɒɡˈmætɪk/	If you are dogmatic, you are certain that you are right and that everyone else is wrong.	He has written a stimulating but dogmatic book.
satire	/ˈsætaɪər/	a way of criticizing people or ideas in a humorous way, especially in order to make a political point, or a piece of writing that uses this style 	political satire
didactic	/daɪˈdæktɪk/	intended to teach, especially in a way that is too determined or eager, and often fixed and unwilling to change 	a didactic approach to teaching
heretical	/həˈretɪkəl/	opposite to or against the official or popular opinion, or showing no respect for the official opinion 	He did not reveal his heretical views on the drug war until after he was reelected.
complaisance	/kəmˈpleɪzəns/	willingness to please others by being polite and fitting in with their plans	
inert	/ɪˈnɜːt/	not moving or not able to move 	The inert figure of a man could be seen lying in the front of the car.
ephemeral	/ɪˈfemərəl/	lasting for only a short time 	Fame in the world of rock and pop is largely ephemeral.
esoteric	/ˌiːsəˈterɪk/	very unusual and understood or liked by only a small number of people, especially those with special knowledge 	He has an esoteric collection of old toys and games.
elegy	/ˈelədʒi/	a sad poem or song, especially remembering someone who has died or something in the past 	Gray's "Elegy Written in a Country Churchyard" is a famous English poem.
urbane	/ɜːˈbeɪn/	(especially of a man) confident, comfortable, and polite in social situations 	Herschel was an urbane, kindly, and generous man.
abate	/əˈbeɪt/	to become less strong 	The storm/wind/rain has started to abate.
culpable	/ˈkʌlpəbəl/	deserving to be blamed or considered responsible for something bad 	He was held culpable (= blamed) for all that had happened.
opaque	/əʊˈpeɪk/	preventing light from travelling through, and therefore not transparent or translucent 	opaque glass/tights
avarice	/ˈævərɪs/	an extremely strong wish to get or keep money or possessions 	Her business empire brought her wealth beyond the dreams of avarice (= an extremely large amount of money).
hyperbole	/haɪˈpɜːbəli/	a way of speaking or writing that makes someone or something sound bigger, better, more, etc. than they are 	The blurb on the back of the book was full of the usual hyperbole - "enthralling", "fascinating", and so on.
ascetic	/əˈsetɪk/	avoiding physical pleasures and living a simple life, often for religious reasons 	They live a very ascetic life.
inveigle	/ɪnˈveɪɡəl/	to persuade someone to do something in a clever and dishonest way, when they do not want to do it 	Her son tried to inveigle her into giving him the money for a car.
emollient	/ɪˈmɒliənt/	a cream or liquid that makes dry or sore skin softer or less painful	an emollient cream
discretion	/dɪˈskreʃən/	the ability to behave without causing embarrassment or attracting too much attention, especially by keeping information secret 	"Can you trust him with this?" "Yes, he's the soul of discretion (= he will not tell other people)."
empirical	/ɪmˈpɪrɪkəl/	based on what is experienced or seen rather than on theory 	This theory needs to be backed up with solid empirical data/evidence.
chary	/ˈtʃeəri/	uncertain and frightened to take risks, or unwilling to take action 	I'm a bit chary of using a travel agency that doesn't have official registration.
penurious	/pəˈnjʊəriəs/	extremely poor	
peruse	/pəˈruːz/	to read through something, especially in order to find the part you are interested in 	He opened a newspaper and began to peruse the personal ads.
exonerate	/ɪɡˈzɒnəreɪt/	to show or state that someone or something is not guilty of something 	The report exonerated the crew from all responsibility for the collision.
preen	/priːn/	If a bird preens or preens itself, it cleans and arranges its feathers using its beak.	Roald always spends ages preening (himself) before he goes out.
disinterested	/dɪˈsɪntrəstɪd/	having no personal involvement or receiving no personal advantage, and therefore free to act fairly 	a disinterested observer/judgment
facetious	/fəˈsiːʃəs/	not serious about a serious subject, in an attempt to be funny or to appear clever  	facetious remarks
redoubtable	/rɪˈdaʊtəbəl/	very strong, especially in character; producing respect and a little fear in others 	Tonight he faces the most redoubtable opponent of his boxing career.
enigmatic	/ˌenɪɡˈmætɪk/	mysterious and impossible to understand completely 	The Mona Lisa has a famously enigmatic smile.
castigation	/ˈkæstɪɡeɪt/	to criticize someone or something severely 	Health inspectors castigated the kitchen staff for poor standards of cleanliness.
ebullience	/ɪbˈʊliənt/	very energetic, positive, and happy 	He wasn't his usual ebullient self.
pious	/ˈpaɪəs/	strongly believing in religion, and living in a way that shows this belief 	She is a pious follower of the faith, never missing her prayers.
quiescence	/kwiˈesəns/	the state of being temporarily quiet and not active 	Through threats and rewards, he ensured the quiescence of Congress.
incipient	/ɪnˈsɪpiənt/	just beginning 	signs of incipient public frustration
accolade	/ˈækəleɪd/	praise and approval 	He's been granted the ultimate accolade - his face on a postage stamp.
odious	/ˈəʊdiəs/	extremely unpleasant and causing or deserving hate 	an odious crime
burgeon	/ˈbɜːdʒən/	to develop or grow quickly 	Love burgeoned between them.
